11111111111111
100000000001P1
10000000C00011
11000000000111
1E0000000000C1
11111111111111
