111111111111111111111111111111111111111
100000000000000C00000C00000000000CCC001
101001010010000010100100000001010110001
101001001010101000100100000001010001001
1P0000000C00C0000000000000000000C1110C1
111111111111100000000111111110011110011
10000100101000100110C00000111C000011111
10000000000000000C000000011111111000001
1000E0000010C111111111111C0000000000001
111111111111111111111111111111111111111
