11111111111111111111111
111P11111111E0000000C11
11101111111111111111011
11101111101111111111011
111011111011C0000000C11
111C00000C0001111111111
11111111101101111111111
111111111011C0000000C11
11111111111111111111111