1111111
1P000C1
10000E1
1000001
1000C01
1000001
100F001
1111111
