1111111111111111111
1P0000C00000C0000F1
1000000000000000001
10000000111000C00E1
1000000000000000001
1C00010000000F00011
1111111111111111111
