1111111111111
100100000C001
1000011111001
1P00011E00C01
1111111111111
