111111K111
10PECC0001
1000000001
1111111111
